************
*   *      *
  * * **** *
 ** *    * *
     *** *  
 * * * * * *
   * * * * *
 * * * * * *
         * *
 ***** *** *
*      *   *
 ***********
